111111111111111111111
100000001111100000001
100000001111100111101
101100101111001111101
101100000000000000101
111100000000000000101
100000011110111101001
100000100000000101001
100001100000000101001
100001100111100101001
100001100111100001101
101100000000000101001
101101111111111101001
101100000001111001101
100000000001111000001
111111111111111111001
100010000000111111101
100000010000000000001
100111111000111000011
100101001000111000001
100000001000000000001
100111111111100000001
100000000000000000001
111111111111111111111
