111111111111111
100000000001101
110000111100001
110000001001101
100110000001101
100110000001101
111110101101101
100000100100001
100000101100001
101100111100001
101100000000001
111111111111111
