11111111111111111111
10000000000000000001
10111111110111111101
10100000000000000101
10101111111111110101
10101000000000010101
10001011111111010101
10101010010101010101
10111010000001000101
10100010000001010101
10100010000001010101
10100011110111010101
10100000000000010101
10101111111111110101
10100000000000000101
10111111111111111101
10000000000000000001
11111111111111111111
