111111111111111111
100000000000000001
101010101010101011
100000000000000001
110101010101010101
100000000000000001
101010101010101011
100000000000000001
110101010101010101
100000001010000001
101010101010101011
100000000000000001
110101010101010101
100000000000000001
101010101010101011
100000000000000001
110101010101010101
100000000000000001
111111111111111111
